"filename", "language", "XML", "Java", "comment", "blank", "total"
"c:\Users\User\Desktop\NCU\Course\OOAD\midterm-project\uml_editor\pom.xml", "XML", 172, 0, 1, 1, 174
"c:\Users\User\Desktop\NCU\Course\OOAD\midterm-project\uml_editor\src\main\java\Editor\Menu.java", "Java", 0, 25, 0, 10, 35
"c:\Users\User\Desktop\NCU\Course\OOAD\midterm-project\uml_editor\src\main\java\Editor\ToolBar.java", "Java", 0, 66, 6, 18, 90
"c:\Users\User\Desktop\NCU\Course\OOAD\midterm-project\uml_editor\src\main\java\Editor\UMLCanvas.java", "Java", 0, 89, 3, 32, 124
"c:\Users\User\Desktop\NCU\Course\OOAD\midterm-project\uml_editor\src\main\java\Editor\UMLEditor.java", "Java", 0, 26, 7, 9, 42
"c:\Users\User\Desktop\NCU\Course\OOAD\midterm-project\uml_editor\src\main\java\Editor_shape\AssociationLine.java", "Java", 0, 15, 0, 6, 21
"c:\Users\User\Desktop\NCU\Course\OOAD\midterm-project\uml_editor\src\main\java\Editor_shape\Basic_Obj.java", "Java", 0, 52, 2, 13, 67
"c:\Users\User\Desktop\NCU\Course\OOAD\midterm-project\uml_editor\src\main\java\Editor_shape\Class_obj.java", "Java", 0, 22, 2, 5, 29
"c:\Users\User\Desktop\NCU\Course\OOAD\midterm-project\uml_editor\src\main\java\Editor_shape\CompositionLine.java", "Java", 0, 31, 0, 13, 44
"c:\Users\User\Desktop\NCU\Course\OOAD\midterm-project\uml_editor\src\main\java\Editor_shape\GenerationLine.java", "Java", 0, 29, 0, 8, 37
"c:\Users\User\Desktop\NCU\Course\OOAD\midterm-project\uml_editor\src\main\java\Editor_shape\Line.java", "Java", 0, 30, 5, 11, 46
"c:\Users\User\Desktop\NCU\Course\OOAD\midterm-project\uml_editor\src\main\java\Editor_shape\Port.java", "Java", 0, 26, 0, 7, 33
"c:\Users\User\Desktop\NCU\Course\OOAD\midterm-project\uml_editor\src\main\java\Editor_shape\Shape.java", "Java", 0, 31, 2, 6, 39
"c:\Users\User\Desktop\NCU\Course\OOAD\midterm-project\uml_editor\src\main\java\Editor_shape\UserCase_obj.java", "Java", 0, 19, 0, 7, 26
"c:\Users\User\Desktop\NCU\Course\OOAD\midterm-project\uml_editor\src\main\java\editor_mode\Mode.java", "Java", 0, 15, 1, 5, 21
"c:\Users\User\Desktop\NCU\Course\OOAD\midterm-project\uml_editor\src\main\java\editor_mode\createLine.java", "Java", 0, 104, 2, 16, 122
"c:\Users\User\Desktop\NCU\Course\OOAD\midterm-project\uml_editor\src\main\java\editor_mode\createObj.java", "Java", 0, 24, 0, 6, 30
"c:\Users\User\Desktop\NCU\Course\OOAD\midterm-project\uml_editor\src\main\java\editor_mode\selectMode.java", "Java", 0, 50, 1, 11, 62
"c:\Users\User\Desktop\NCU\Course\OOAD\midterm-project\uml_editor\src\test\java\com\example\AppTest.java", "Java", 0, 9, 6, 4, 19
"c:\Users\User\Desktop\NCU\Course\OOAD\midterm-project\uml_editor\target\classes\Editor\Menu$GraoupObj.class", "Java", 0, 14, 0, 0, 14
"c:\Users\User\Desktop\NCU\Course\OOAD\midterm-project\uml_editor\target\classes\Editor\Menu.class", "Java", 0, 14, 0, 0, 14
"c:\Users\User\Desktop\NCU\Course\OOAD\midterm-project\uml_editor\target\classes\Editor\ToolBar$ToolBtn$toolListener.class", "Java", 0, 20, 0, 0, 20
"c:\Users\User\Desktop\NCU\Course\OOAD\midterm-project\uml_editor\target\classes\Editor\ToolBar$ToolBtn.class", "Java", 0, 13, 0, 0, 13
"c:\Users\User\Desktop\NCU\Course\OOAD\midterm-project\uml_editor\target\classes\Editor\ToolBar.class", "Java", 0, 36, 0, 1, 37
"c:\Users\User\Desktop\NCU\Course\OOAD\midterm-project\uml_editor\target\classes\Editor\UMLCanvas.class", "Java", 0, 42, 2, 0, 44
"c:\Users\User\Desktop\NCU\Course\OOAD\midterm-project\uml_editor\target\classes\Editor\UMLEditor.class", "Java", 0, 22, 0, 1, 23
"c:\Users\User\Desktop\NCU\Course\OOAD\midterm-project\uml_editor\target\classes\Editor_shape\AssociationLine.class", "Java", 0, 9, 0, 0, 9
"c:\Users\User\Desktop\NCU\Course\OOAD\midterm-project\uml_editor\target\classes\Editor_shape\Basic_Obj.class", "Java", 0, 40, 0, 1, 41
"c:\Users\User\Desktop\NCU\Course\OOAD\midterm-project\uml_editor\target\classes\Editor_shape\Class_obj.class", "Java", 0, 16, 0, 0, 16
"c:\Users\User\Desktop\NCU\Course\OOAD\midterm-project\uml_editor\target\classes\Editor_shape\CompositionLine.class", "Java", 0, 21, 0, 0, 21
"c:\Users\User\Desktop\NCU\Course\OOAD\midterm-project\uml_editor\target\classes\Editor_shape\GenerationLine.class", "Java", 0, 21, 0, 0, 21
"c:\Users\User\Desktop\NCU\Course\OOAD\midterm-project\uml_editor\target\classes\Editor_shape\Line.class", "Java", 0, 15, 0, 0, 15
"c:\Users\User\Desktop\NCU\Course\OOAD\midterm-project\uml_editor\target\classes\Editor_shape\Port.class", "Java", 0, 22, 0, 0, 22
"c:\Users\User\Desktop\NCU\Course\OOAD\midterm-project\uml_editor\target\classes\Editor_shape\Shape.class", "Java", 0, 16, 0, 0, 16
"c:\Users\User\Desktop\NCU\Course\OOAD\midterm-project\uml_editor\target\classes\Editor_shape\UserCase_obj.class", "Java", 0, 15, 0, 0, 15
"c:\Users\User\Desktop\NCU\Course\OOAD\midterm-project\uml_editor\target\classes\editor_mode\Mode.class", "Java", 0, 18, 0, 0, 18
"c:\Users\User\Desktop\NCU\Course\OOAD\midterm-project\uml_editor\target\classes\editor_mode\createLine.class", "Java", 0, 42, 0, 0, 42
"c:\Users\User\Desktop\NCU\Course\OOAD\midterm-project\uml_editor\target\classes\editor_mode\createObj.class", "Java", 0, 17, 0, 0, 17
"c:\Users\User\Desktop\NCU\Course\OOAD\midterm-project\uml_editor\target\classes\editor_mode\selectMode.class", "Java", 0, 25, 4, 0, 29
"c:\Users\User\Desktop\NCU\Course\OOAD\midterm-project\uml_editor\target\test-classes\com\example\AppTest.class", "Java", 0, 10, 0, 0, 10
"Total", "-", 172, 1111, 44, 191, 1518